# KEYWORD1 Classes, datatypes, and C++ keywords
# KEYWORD2 Methods and functions
# LITERAL1 Constants

###########################
# Instinct Library        #
###########################

INSTINCT_NODE_TYPES	LITERAL1
INSTINCT_ACTIONPATTERN	LITERAL1
INSTINCT_ACTIONPATTERNELEMENT	LITERAL1
INSTINCT_COMPETENCE	LITERAL1
INSTINCT_COMPETENCEELEMENT	LITERAL1
INSTINCT_DRIVE	LITERAL1
INSTINCT_ACTION	LITERAL1
INSTINCT_COMPARATOR_EQ	LITERAL1
INSTINCT_COMPARATOR_NE	LITERAL1
INSTINCT_COMPARATOR_GT	LITERAL1
INSTINCT_COMPARATOR_LT	LITERAL1
INSTINCT_COMPARATOR_TR	LITERAL1
INSTINCT_COMPARATOR_FL	LITERAL1
INSTINCT_STATUS_NOTRUNNING	LITERAL1
INSTINCT_STATUS_RUNNING	LITERAL1
INSTINCT_STATUS_INTERRUPTED	LITERAL1
INSTINCT_FAIL	LITERAL1
INSTINCT_SUCCESS	LITERAL1
INSTINCT_IN_PROGRESS	LITERAL1
INSTINCT_ERROR	LITERAL1
INSTINCT_RUNTIME_NOT_TESTED	LITERAL1
INSTINCT_RUNTIME_SUCCESS	LITERAL1
INSTINCT_RUNTIME_IN_PROGRESS	LITERAL1
INSTINCT_RUNTIME_ERROR	LITERAL1
INSTINCT_RUNTIME_FAILED	LITERAL1
INSTINCT_RUNTIME_NOT_RELEASED	LITERAL1

# these are macros, like functions
INSTINCT_RTN	KEYWORD2
INSTINCT_RTN_DATA	KEYWORD2
INSTINCT_RTN_COMBINE	KEYWORD2

# namespace
Instinct	KEYWORD1

# data types
instinctID	KEYWORD1
senseID	KEYWORD1
actionID	KEYWORD1
instinctID	KEYWORD1
senseID	KEYWORD1
actionID	KEYWORD1
ReleaserType	KEYWORD1
PriorityType	KEYWORD1
DrivePriorityType	KEYWORD1
FrequencyType	KEYWORD1
RetryType	KEYWORD1
RuntimeCounters	KEYWORD1
RuntimeReferences	KEYWORD1
ParentChildReferences	KEYWORD1
ActionPatternType	KEYWORD1
ActionPatternElementType	KEYWORD1
CompetenceType	KEYWORD1
CompetenceElementType	KEYWORD1
DriveType	KEYWORD1
ActionType	KEYWORD1
PlanElement	KEYWORD1
PlanNode	KEYWORD1

# classes
Senses	KEYWORD1
Actions	KEYWORD1
Monitor	KEYWORD1
PlanManager	KEYWORD1
Planner	KEYWORD1
CmdPlanner	KEYWORD1
Names	KEYWORD1

# methods
setPlanID	KEYWORD2
getPlanID	KEYWORD2
executeCommand	KEYWORD2
initialisePlan	KEYWORD2
planSize	KEYWORD2
planUsage	KEYWORD2
maxElementID	KEYWORD2
addNode	KEYWORD2
addDrive	KEYWORD2
addCompetenceElement	KEYWORD2
addActionPattern	KEYWORD2
addActionPatternElement	KEYWORD2
addAction	KEYWORD2
addCompetence	KEYWORD2
getNode	KEYWORD2
updateNode	KEYWORD2
monitorNode	KEYWORD2
setGlobalMonitorFlags	KEYWORD2
sizeFromNodeType	KEYWORD2
runPlan	KEYWORD2
processTimers	KEYWORD2
readSense	KEYWORD2
executeAction	KEYWORD2
executeCommand	KEYWORD2
displayNode	KEYWORD2
displayNode	KEYWORD2
displayNodeCounters	KEYWORD2
displayNodeCounters	KEYWORD2
displayReleaser	KEYWORD2
addElementName(const instinctID bRuntime_ElementID, char *pElementName);
getElementName(const instinctID bRuntime_ElementID);
clearElementNames	KEYWORD2
elementNameCount	KEYWORD2
elementBuffer	KEYWORD2
elementBufferSize	KEYWORD2
maxElementNameID	KEYWORD2
